R 1920           1080
NO ./textures/redbrick.xpm
SO ./textures/wood.xpm
WE ./textures/mossy.xpm
EA ./textures/colorstone.xpm
S ./textures/barrel.xpm
F 1,2,3
C 4,5,6
1111111111111111
1002000000000001
1200000000000001111111111111111111111
1200000000000000000000000000000000011
1020000000000001111111111110000000001
1000000000000001          10000000001
1111111111111111          10000000001
                         10000011111
                        10000001
                        10000001
                        10000001
                        10000001
                        10000001
                        10000001
                        10000001
                        10000001
                        10000001
                        10000001
                        10000001
                        10000001
                        10000001
                        1000W001
                        11111111
