R 1920           1080
NO ./textures/redbrick.xpm
SO ./textures/wood.xpm
WE ./textures/mossy.xpm
EA ./textures/colorstone.xpm
S ./textures/barrel.xpm
F 1,2,3
C 4,5,6
111111111111111111111111111111111111111
100000000000000000000000000000000000011
10000000000000000000000000000000000000000111
1000000000000000000000000000000000000001
		10000000000000000000000000000000000000N00011
    10000000000000000000000000000000000000000011
    100000000000000000000000000000000000011
  	  10000000000000000000000000000000000000000011
    10000000000000000000000000000000000000000011
111100000000000000000000000000000000011
10000000000000000000000000000000000000000011
10000000000000000000000000000000000000000011
10000000000000000000000000000000000000000011
10000000000000000000000000000000000000000011
10000000000000000000000000000000000000000011
1000000000000000000000000000000000000000011
10000000000000000000000000000000000000000011
10000000000000000000000000000000000000000011
10000000000000000000000000000000000000000011
1000000000000000000000000000000000000011
100000000000000000000000000000000000000011
10000000000000000000000000000000000000000011
100000000000000000000000000000000000011
10000000000000000000000000000000000000000011
100000000000000000000000000000000000011
10000000000000000000000000000000000000000011
10000000000000000000000000000000000000000011
10000000000000000000000000000000000000000011
10000000000000000000000000000000000000000011
10000000000000000000000000000000000000000011
11111111111111111111111111111111111111111111

