R 1920           1080
NO ./textures/redbrick.xpm
SO ./textures/wood.xpm
WE ./textures/mossy.xpm
EA ./textures/colorstone.xpm
S ./textures/barrel.xpm
F 1,2,3
C 4,5,6
111111111111111111111111
100000002000000000000011
100000000000000000200011
100000000000000000000001
100000002000000000000011
100000000000000200000011
100000000000000000000001
100000002000000000000011
100000000000002000000011
100002000000000000000011
100000002000000000000011
100002000000000000000011
10000000000000000W000001
111111111111111111111111



