R 1920           1080
NO ./textures/redbrick.xpm
SO ./textures/wood.xpm
WE ./textures/mossy.xpm
EA ./textures/colorstone.xpm
S ./textures/barrel.xpm
F 1,2,3
C 4,5,6
111111111
100020001
100000001
100000001
100000001
100000001
0000100000001
000100000001
00100000001
0100002001
100000001
 100000001
  100200001
   100200001
    100000001
     100000001
    102000001
   100000001
  100020001
 100200W01
111111111



