R 1920           1080
NO ./textures/redbrick.xpm
SO ./textures/wood.xpm
WE ./textures/mossy.xpm
EA ./textures/colorstone.xpm
S ./textures/barrel.xpm
F 1,2,3
C 4,5,6
111111111111111111111111111111111111111
100000000000000000000000000000000000011
10000000000000000000000000000000000000000111
10000000000000000000000wer000000000000000000001
    10000000000000000000000000000000000000N00011
    10000000000000000000000000000000000000000011
    10000000000000000er000000000000000000000000011
    10000000000000000000000000000000000000000011
    10000000000000000000000000000000000000000011
1111000000000000000000000d000000000000000011
10000000000000000000000000000000000000000011
10000000000000000000000000000000000000000011
		10000000000000000000000000000000000000000011
		10000000000000000000000000000000000000000011
		10000000000000000000000000000000000000000011
10000000000000000000000000c000000000000000011
10000000000000000000000000000000000000000011
10000000000000000000000000000000000000000011
10000000000000000000000000000000000000000011
100000000000000c00000000000000000000000000011
1000000000000000000000000000m0000000000000011
10000000000000000000000000000000000000000011
100000000000v00000000000000000000000000000011
10000000000000000000000000000000000000000011
100000000000000000000000n00000000000000000011
10000000000000000000000000000000000000000011
10000000000000000000000000000000000000000011
10000000000000000000000000000000000000000011
10000000000000000000000000000000000000000011
10000000000000000000000000000000000000000011
11111111111111111111111111111111111111111111

