R 1920           1080
NO ./textures/redbrick.xpm
SO ./textures/wood.xpm
WE ./textures/mossy.xpm
EA ./textures/colorstone.xpm
S ./textures/barrel.xpm
F 1,2,3
C 4,5,6
111111111
122222221
100200001
100020001
100002001
100020001
100200001
100000001
100000001
100000001
100000001
100000001
100000001
100000001
100000001
100000001
100000001
100000001
100000001
100000W01
111111111



