R 1920 1080
NO ./cub3d_materials/no.texture
SO ./cub3d_materials/so.texture
WE ./cub3d_materials/we.texture
EA ./cub3d_materials/ea.texture
S ./cub3d_materials/s.texture
F 220,100,0
C 225,30,0
1111111111111111111111111
1000000000110000000000001
1011000001110000002000001
1001000000000000000000001
11111111101100000111000001111
10000000001100000111000000001
11110111111111011100000010001
11110111111111011101010010001
11000000110101011100000010001
10002000000000001100000010001
10000000000000001101010010001
11000001110101011111011110N01
11111111111111111111111111111
