R 1200 600
NO ./textures/NO.xpm
SO ./textures/SO.xpm
WE ./textures/WE.xpm
EA ./textures/EA.xpm
S ./textures/EGG.xpm
TF ./textures/TF.xpm
UT ./textures/UT.xpm
F 44,41,49
C 200,200,200

11111111111111111111
10200002000000002001
10000020000000200001
10200002000000200001
10002000000020000001
10020000200000000001
10000200200002000001
10200000020000002001
1N000020002000200001
11111111111111111111
