R 1200 600
NO ./textures/brick.xpm
SO ./textures/wood.xpm
WE ./textures/blue.xpm
EA ./textures/grey.xpm
S ./textures/barrel.xpm
F 255,255,255
C 255,125,0
111111111111111111
100000000000000001
100200020000200201
100000000002000001
100000020000211111
100002000000000001
100020001000000001
100000000000200001
1000200000N0000001
111111111101111111
        1100111111111111111111111
        1000000000110000000000001
        1011000001110000002000001
        1001000000000000200000001
111111111011000001110000000000001
100000000011000001110111111111111
11110000011000001100000010001
11110000011111011101010010001
11000000110101011100000010101
10002000000000000000000010001
10000000000000001101010000001
11000001110101011111011110001
11110111 1110101 101111010001
11111111 1111111 111111111111
