R 1200 600
NO ./textures/NO.xpm
SO ./textures/SO.xpm
WE ./textures/WE.xpm
EA ./textures/EA.xpm
S ./textures/EGG.xpm
TF ./textures/TF.xpm
UT ./textures/UT.xpm
F 44,41,49
C 200,200,200

111111111111111111
100000000000002001
100000000000000001
100000200000000001
100000000000000001
100000000000000001
100000000002000001
100000000000002001
1N0000200000000001
111111111111111111
