R 1280 600
NO ./textures/NO.xpm
SO ./textures/SO.xpm
WE ./textures/WE.xpm
EA ./textures/EA.xpm
S ./textures/EGG.xpm
TF ./textures/TF.xpm
UT ./textures/UT.xpm
F 44,41,49
C 200,200,200

111111111111
100000011111
111110111111111111
100200020002000001
100000020000002001
100200000000000001
1000S0001000011111
120002000002000001
100002000002000201
100000000001000001
100020002000020001
111111111101111111
        1100111111111111111111111
        1000000000110000000000001
        1011000001110000002000001
        1001000000000000200000001
111111111011000001110000200020001
100000000011020001110111111111111
11110020011000001100000010001
11110000011111011101010010001
11002000110101011100000010101
10002002000020002000000010001
10020002000020001101010000001
11000001110101011111011110001
11110111 1110101 101111010001
11111111 1111111 111111111111
