R 1200 600
NO ./textures/NO.xpm
SO ./textures/SO.xpm
WE ./textures/WE.xpm
EA ./textures/EA.xpm
S ./textures/EGG.xpm
TF ./textures/TF-2.xpm
UT ./textures/UT.xpm
F 44,41,49
C 200,200,200

111111111111111111
100000000000000001
100000020000000001
100200000000000001
100000002000000001
100002000000000001
100000000002000001
100000000000000001
1N0000000000000001
111111111111111111
